@Turn		1

@TurnsTaken	0

@MapDims	16


@Map
0 0 0 0 0 0 0 0 A 0 A 0 A 0 A 0
0 0 0 0 0 0 0 0 0 B 0 B 0 B 0 B
0 0 0 0 0 0 0 0 C 0 C 0 C 0 C 0
0 0 0 0 0 0 0 0 0 D 0 D 0 D 0 D
0 0 0 0 0 0 0 0 0 0 0 0 0 0 0 0
0 0 0 X X X X X X X X X X 0 0 0
0 0 0 X 0 0 0 0 0 0 0 0 X 0 0 0
0 0 0 X 0 0 0 0 0 0 0 0 X 0 0 0
0 0 0 X X X X X X X X X X 0 0 0
0 0 0 0 0 0 0 0 0 0 0 0 0 0 0 0
0 0 0 0 0 0 0 0 0 0 0 0 0 0 0 0
0 0 0 0 0 0 0 0 0 0 0 0 0 0 0 0
1 0 1 0 1 0 1 0 0 0 0 0 0 0 0 0
0 2 0 2 0 2 0 2 0 0 0 0 0 0 0 0
3 0 3 0 3 0 3 0 0 0 0 0 0 0 0 0
0 4 0 4 0 4 0 4 0 0 0 0 0 0 0 0

@end



